%%%%%%
%....%
%.%%.%
%.%%.%
%.P..%
%.%%%%
%....%
%%%%%%
