%%%%%%%%%%%%%%%%%%%%%%%%%%%%%%%%%%%%%%%%%%%%%%%%%
% .  %.        %       .     %  .%     % %   %  %
% %  %%%% %%%%%% %  % % %%         %%%%  %. %%% %
% %  %.%    %  % %  % %  %   %   %          %   %
%                %.     %%%% %   %%  %%% %      %
% %%%%% %%%%%%  %%%% %       .    %    %. %%%%%%%
%       %   .%       .% %%%  %%%%%%  % %  %   % %
%%% %%  % %%%%%%% %%%%% %    %    %% % %    % % %
%    %  %   %  %  %      P% %%       %   %%%% % %
%.      %   %  %  %     %          %       .%   %
% % %%%    % %    %% %% %%% %% %  %.%%%%%%%%%%% %
%   %    %               .   %    %             %
%%%%%%%%%%%%%%%%%%%%%%%%%%%%%%%%%%%%%%%%%%%%%%%%%
