%%%%%%%%%%%%%%%%%%%%%%%%%%%%%%%%%%%%
%                                 P%
% %%%%%%%%%%%%%%%%%%% %%% %%%%%%%% %
% %%   %   %      %%% %%%   %% ... %
% %% % % % % %%%% %%%%%%%%% %% %%%%%
% %% % % % % %    %%     %% %% ... %
% %% % % % % % %%%%  %%%    %%%%%% %
% %  % % %   %    %% %%%%%%%%  ... % 
% %% % % %%%%%%%% %%        %% %%%%%
% %% %   %%       %%%%%%%%% %% . . %
%    %%%%%% %%%%%%%      %% %%%%%% %
%%%%%%      %       %%%% %% %  ... %
%      %%%%%% %%%%% %    %% %% %%%%%
% %%%%%%      %.      %%%%% %%     %
%        %%%%%%.%%%%%%%%%%% %%  %% %
%%%%%%%%%%                  %%%%%% %
%..... ....%%%%%%%%%%%%%%%% ... .. %
%%%%%%%%%%%%%%%%%%%%%%%%%%%%%%%%%%%%
