%%%%%%%%%%%%%%%%%%%%
%.           ...P .%
%.%% %%.%%.%%.%% %.%
% %%.%.....   .  %.%
%%%%%%%%%%%%%%%%%%%%
