%%%%%%%%%
%..   ..%
%%%%.%% %
%   P  .%
%.%% %%.%
%.%.   .%
%%%%%%%%%
