%%%%%%%%%%%%%%%%%%%%%%%%%%%%%%%%%%%%%
%.      %                         %.%
%         %%%%% % %%% %%% %%%%%%% % %
%       %       % %     %     % %   %
%%%%% %%%%% %%% % % % %%% %%%%% % %%%
%   % % % %   % % % %   % %     %   %
% %%% % % % %%% %%%%% %%% % %%% %%% %
%       %     %   %   %     % % %   %
%%% %%%%%%%%% %% %%%% %%% %%% % % % %
%             %       % %   %     % %
% % % %%% % %%% % % %%% % %%% %%% % %
% % %     % % % % %     %   % % % % %
% % % %%%%%%% % %%%% %%%% %%% % %%% %
% % %P%     %   %     %     %   %   %
%%% %%% % %%%%% %%%%% %%% %%% %%%%% %
%     % %               % %   % % % %
% % % % % % % % % %%% %%% % % % % % %
% % % % % % % % % % % %   % % %     %
% % % % % % % % % % % %   % % %     %
% % % % % % % % %     %   % % %     %
%       % % % % % % % %   % % %     %
% % % % % % % % % % % %   % % %     %
% % % % %     % % % % %   % % %     %
% % % % % % % % % % % %   % % %     %
% % % % % % % % % % % %   % % %     %
% % % % % % % % % % % %   % % %     %
% % % % % % % % % % % %   % % %     %
% % % % % % % % % % % %       %     %
% % %%%%% %%% %%% %%% % %%% %%% %%%%%
%       %   %   % % % %       % %   %
% %%% % %   %   % %%% %%%%%%%%% % %%%
%   % %                   %   % %   %
% %%% %%%%%%%%%%%%%%%%%%%%% % % %%% %
% %                         %       %
% % % %%%%% %%% % % % % %%%%%%%%%%%%%
% % %   %     % % % %       %   % % %
% % %%% %%% % % % %%%%%%%%% %%% % % %
% %   % %   % % %   % %   % % %     %
% %%% %%% %%% % %%% % % %%%%% % %%%%%
%       %   %     %       %   % %   %
%%% % %%%%% %%%%% %%% %%% % %%% % %%%
% % % % % % % %     % %   % %   % % %
% % %%% % % % % %%%%%%%%% % % % % % %
%       %                     %     %
% %   % %%% %%% %%%%%%% %%% %%% %%% %
%.%   %       %           %     %  .%
%%%%%%%%%%%%%%%%%%%%%%%%%%%%%%%%%%%%%
