%%%%%%%%
%.    .%
%      %
% %%%% %
% %P   %
% % %%%%
%.%   .%
%%%%%%%%
