%%%%%%%%%%%%%%%%%%%%%%%%%%%%%%%%%%%%%%%%%
%.....%...          ..............%.....%
%.%%%.%.%%%.%%%%%%%.%%%          .%.....%
%.%...%.%.....  %.   %  .%......%.%.....%
%...%%%.%.%%%%  %  . %...%.%%%%...%%%...%
%%%.%.%.%.%....  % %     ..%..%.%...%.%%%
%...%.%%%.%.%%%   %   %   %%%.%.%%%.%...%
%.%%%.......%        ...... %.......%%%.%
%...%.%%%%%.%%%          %%%%.%.%%%.%...%
%%%.          %...%.%....%....%.%...%.%%%
%...%          %%.%.%%%%.%.%%%%.%.%%%...%
%.......%......%...  %.... % ...%.....%.%
%.....%.%%%.%%%%% %        %%.%%%.%.%%%.%
%.....%........   %.     P....%...%.....%
%%%%%%%%%%%%%%%%%%%%%%%%%%%%%%%%%%%%%%%%%
