%%%%%%%%%%%%%%%%%%%%
%...%.........%%...%
%.%.%.%%%%%%%%%%.%.%
%..................%
%%%%%%%%.%.%%%%%%%P%
%%%%%%%%.......% . %
%%%%%%%%.......  . %
%%%%%%%%.......%   %
%%%%%%%%.......%   %
%%%%%%%%%%%%%%%%%%%%
