%%%%%%%
%    P%
% %%% %
%     %
%  % %%
%% % .%
%%%%%%%
